//Exemple un peu complexe
20 20
####################
##...............O##
##.####.##.###.#####
##.####.##.###.#####
##.####....###.#####
##O####.######.#####
#######.######...F##
##........####.#####
##.###.#####.#.#####
##.###.#.....#.#..##
######.####.##...###
#...........##.#.O##
#.###.###.####.#####
#.....###.####....##
#.###.###.####.##.##
#.###.###.####.##.##
###........###.##.##
##########.###....##
##P............#####
####################
