/Vérification si on évite un fantôme
10 10
##########
#........#
#. #  # .#
#.######.#
#.######.#
#.######.#
#.######.#
# ###### #
#P..F...O#
##########
