/Vérification si choix du plus court chemin
10 10
##########
#........#
#. # F# .#
#.######.#
#.######.#
#.######.#
#.######.#
# ###### #
#P......O#
##########
