50 100
####################################################################################################
#............#...#.......#................................................................#........#
#............#.#.#.#####.#...###########################################################..#........#
#............#.#.#.....#.#...#####################################################.....#..#........#
#............#.#.#####.#.#...##...............F#............O...................##.....#..#........#
#............#.#.......#.#...##....#############.........F...........########...##.....#..#........#
#............#.#########.#...##......................................#F.........##.....#..#........#
#............#.........#.#...##########################.....######################.....#..#........#
#............########..#.#.............................................................#..#........#
#............#.........#.#.............................................................#..#........#
#............##.####.###.###############################################################..#........#
#............#........O#..................................................................#........#
#............#.##.###..####################################################################........#
#............#.........#...........................................................................#
#............#.........#...........................................................................#
#............#.........#..................................#####....................................#
#............#.........#..................................#.O..#...................................#
#............#.........#.................................#.#....#..................................#
#............#.........#................................#...#....#.................................#
#............#.........#...............................#.....#....#................................#
#............#.........#..............................#............#...............................#
#............#.........#.............................#.........#....#..............................#
#............#.........#............................#...........#....#.............................#
#............#.....................................###############....#............................#
#............#....................................#...............#....#...........................#
#............#...................................#.................#....#..........................#
#............#..................................#...................#....#.........................#
#..............................................#.....................#....#........................#
#.............................................#.......................#....#.......................#
#.....................................#########.......................##....#......................#
#.................................#################................................................#
#............................#####.................................................................#
#...........................#O.....................................................................#
#.........................##.......................................................................#
#.........................##.......................................................................#
#........................###..........##########################.###...............................#
#.......................####..........#.......#.....#.#.#..........#...............................#
#......................#####..........#.....P.#...#.#..............#...............................#
#.......................####..........#...........#...###..........#...............................#
#........................###..........##############################...............................#
#.........................##.......................................................................#
#.........................##.......................................................................#
#...........................#......................................................................#
#............................####..................................................................#
#................................#################.................................................#
#....................................##########....................................................#
#..................................................................................................#
#..................................................................................................#
#......................O...........................................................................#
####################################################################################################