20 20
#####################
##O....#.....#....F##
###....#..#..#....###
####...#..#..#...####
#####..#..#..#..#####
######....#....######
#######...#...#######
########..#..########
#########...#########
##########P##########
#########...#########
########..#..########
#######...#...#######
######....#....######
#####..#..#..#..#####
####...#..#..#...####
###....#..#..#....###
##F....#.....#....O##
#####################
#####################
