/Un exemple de carte 10x10
10 10
##########
#........#
#. # F# .#
#.  ##  .#
#.   O  .#
#.  ##  .#
#........#
# ##..## #
# .....P #
##########
